CANaero	KEYWORD1
DumpCanFrame	KEYWORD2
DumpMessage	KEYWORD2
ParamAdvertise	KEYWORD2
ParamPublish	KEYWORD2
ParamRead	KEYWORD2
ParamSubscribe	KEYWORD2
ParamUnadvertise	KEYWORD2
ParamUnsubscribe	KEYWORD2
ServiceRegister	KEYWORD2
ServiceUnregister	KEYWORD2
Timestamp	KEYWORD2
Update	KEYWORD2
setNodeId	KEYWORD2
_CanServiceLinks	KEYWORD1
_CanDataLinks	KEYWORD1
CanasMessage	KEYWORD1
CanasDataContainer	KEYWORD1
CanasMessageData	KEYWORD1
CanasServiceResponseCallbackArgs	KEYWORD1
CanasParamCallbackArgs	KEYWORD1
CanasParamCacheEntry	KEYWORD1
CanasServiceSubscription	KEYWORD1
CanasInstanceStruct	KEYWORD1
CanasServiceRequestCallbackArgs	KEYWORD1
CanasParamAdvertisement	KEYWORD1
CanasServicePollCallbackArgs	KEYWORD1
CanasParamSubscription	KEYWORD1
CanasConfig	KEYWORD1
CanasHookCallbackArgs	KEYWORD1
CanasServiceFrameHistoryEntry	KEYWORD1
CANAS_service_identification	KEYWORD1
SendResponse	KEYWORD2
CanasSrvIdsPayload	KEYWORD1
CANAS_service_requestdata	KEYWORD1
SendRequest	KEYWORD2
CanasSrvReqDataPayload	KEYWORD1
CANAS_service	KEYWORD1
ProcessFrame	KEYWORD2
SendRequest	KEYWORD2
SendResponse	KEYWORD2
_request	KEYWORD2
replyToIDCall	KEYWORD2
requestID	KEYWORD2
serviceId	KEYWORD2
CanasCanFilterConfig	KEYWORD1
CANdriver	KEYWORD1
areo2can	KEYWORD2
can2areo	KEYWORD2
frame2msg	KEYWORD2
receive	KEYWORD2
setFilter	KEYWORD2
timeStamp	KEYWORD2
writeMsg	KEYWORD2
CanasCanFrame	KEYWORD1
GenericIndicator	KEYWORD1
calibrate	KEYWORD2
getCanAeroId	KEYWORD2
powerOff	KEYWORD2
powerOn	KEYWORD2
powerState	KEYWORD2
setCanAeroId	KEYWORD2
setValue	KEYWORD2
startCommunication	KEYWORD2
type	KEYWORD2
IndicatorDisplay	KEYWORD1
powerOff	KEYWORD2
powerOn	KEYWORD2
IndicatorStepper	KEYWORD1
powerOff	KEYWORD2
powerOn	KEYWORD2
setDirectionInverse	KEYWORD2
setOffPosition	KEYWORD2
Instrument	KEYWORD1
addIndicator	KEYWORD2
calibrate	KEYWORD2
initiateCommunication	KEYWORD2
lightState	KEYWORD2
powerState	KEYWORD2
toZero	KEYWORD2
update	KEYWORD2
updateNow	KEYWORD2
Instrument::indicatorControl	KEYWORD1
Stepper360	KEYWORD1
calibrate	KEYWORD2
halCallback	KEYWORD2
powerOff	KEYWORD2
powerOn	KEYWORD2
setValue	KEYWORD2
StepperPie	KEYWORD1
calibrate	KEYWORD2
moveToBackstop	KEYWORD2
powerOff	KEYWORD2
setValue	KEYWORD2
VidStepper	KEYWORD1
calibrate	KEYWORD2
move	KEYWORD2
moveTo	KEYWORD2
powerOff	KEYWORD2
powerOn	KEYWORD2
run	KEYWORD2
runToPosition	KEYWORD2
set360	KEYWORD2
setMinPulseWidth	KEYWORD2
setRange	KEYWORD2
setRangeValues	KEYWORD2
setReverse	KEYWORD2
setStepsPerRotation	KEYWORD2
setValue	KEYWORD2
Xcomm	KEYWORD1
addElement	KEYWORD2
checkQueue	KEYWORD2
processInput	KEYWORD2
setValue	KEYWORD2
Xcomm::_DataLinks	KEYWORD1
XServo	KEYWORD1
moveMax	KEYWORD2
moveMin	KEYWORD2
moveTo	KEYWORD2
powerOff	KEYWORD2
powerOn	KEYWORD2
